GC:N GD:
V V V V V V V V V V V V
V V V V V V V V V V V V
V V V V V V V V V V V V
V V V V V V V V V V V V
V V V V V V V V V V V V
W W W W W W W W W W W W
W F F F F F F F F F F W
D:L:0:! F F F E K F F F F F A:U:1:B
W F F F F F F F F F F W
W W W W W W W W W W W W
V V V V V V V V V V V V
V V V V V V V V V V V V
V V V V V V V V V V V V
V V V V V V V V V V V V
V V V V V V V V V V V V
V V V V V V V V V V V V