GC:N GD:
V V W W W W DU3D W W W V V
V V W F F F F F F W V V
V V W F F F F F F W V V
W W W F F F F F F W W W
W F F F F F F F F F F W
W F F F F F F F F F F W
W F F F F F F F F F F W
AU1A F F F F F F F F F F AU2C
W F F F F F F F F F F W
W F F F F F F F F F F W
W F F F F F F F F F F W
W F F F F F F F F F F W
W W W F F F F F F W W W
V V W F F F F F F W V V
V V W F F F F F F W V V
V V W W W W AU4E W W W V V