GC:N GD:
V V V V V V V V V V V V
V V V V V V V V V V V V
V V V V V V V V V V V V
V V V V V V V V V V V V
V V V V V V V V V V V V
W W W W W W W W W W W W
W F F F F F F F F F F W
A:U:3:B F F F F F F F F F F D:U:8:G
W F F F F F F F F F F W
W W W W W W W W W W W W
V V V V V V V V V V V V
V V V V V V V V V V V V
V V V V V V V V V V V V
V V V V V V V V V V V V
V V V V V V V V V V V V
V V V V V V V V V V V V