GC:N GD:
V V V V W W A:U:4:B W W V V V
V V V V W F F F W V V V
V V V V W F F F W V V V
V V V V W F F F W V V V
V V V V W F F F W V V V
V V V V W F F F W V V V
W W W W W F F F W V V V
A:U:5:F F F F F F F F W V V V
A:U:6:F F F F F F F F W V V V
A:U:7:F F F F F F F F W V V V
W W W W W W W W W V V V
V V V V V V V V V V V V
V V V V V V V V V V V V
V V V V V V V V V V V V
V V V V V V V V V V V V
V V V V V V V V V V V V