GC:N GD:
V V V W W D:U:4:B W V V V V V
V V V W F F W V V V V V
V V V W F F W W W V V V
V V W W F F B F W W V V
V V W F B B F B F W V V
V V W F B F B F F W W W
V V W W W B F F F F F A:U:5:F
V V W F W W B F F F F A:U:6:F
V V W F F F B B F W W W
V V W F F F F B B W V V
V V W W W W W W W W V V
V V V V V V V V V V V V
V V V V V V V V V V V V
V V V V V V V V V V V V
V V V V V V V V V V V V
V V V V V V V V V V V V