GC:N GD:
V V V V V V V V V V V V
V V V V V V V V V V V V
V V V V V V V V V V V V
V V V V V V V V V V V V
V V V V V V V V V V V V
W W W W W W V V V V V V
A:U:5:E F F F F W V V V V V V
A:U:6:E F F F F W V V V V V V
W W W W G W V V V V V V
V V V W W W V V V V V V
V V V V V V V V V V V V
V V V V V V V V V V V V
V V V V V V V V V V V V
V V V V V V V V V V V V
V V V V V V V V V V V V
V V V V V V V V V V V V