GC:S GD:7 GR:KE
V V V V V V V V V V V V
V W W W W W W W W W W V
V W F F F F S F F F W V
V W F F F F S F F F W V
V W F F F W W W F F W V
V W F F F F F F F F W V
W W F F F F F F F F W V
D:L:7:D F F F F F S S F F W V
W W F F F F F F F F W V
V W F F F F F F F F W V
V W F F F F F F F F W V
V W F F W W W W W F W V
V W F F F F F S W F W V
V W F F F F F S W T W V
V W W W W W W W W W W V
V V V V V V V V V V V V