GC:P GD:1,2
W W W W W W W W W W W W
W F F F F F F F F F F W
W F F F F F F F F F F W
W F F F F F F F F F F W
W F F F F F F F F F F W
W F F P F F F F F F F W
W F F B F F F F F F F DL1
W F F F F F F F F F F W
W F F F F B P F F F F W
W F F F F F F F F F F W
W F F F F F F F F F F W
W F F F F F F F F F F W
W F F F F F F F F F F W
W F F F F F F F F F F W
W F F F F F F F F F F W
W W W W W W W W W W W W